You're practically ripping out your hair from stress.  Today is the date of the school dance, which you still don't have a date for.  To make matters worse, there's the major chemistry exam worth 40% of your grade that you haven't studied for yet.  On top of that, you're already late for school.  Oh, yeah, and you're locked in the basement.

A Day in the Life of a Teenage Wizard
Ordinary Problems, Magical Solutions by Justin Kunimune
Release 1 / Serial number 131018 / Inform 7 build 6G60 (I6/v6.32 lib 6/12N) SD

Basement
The basement is a dark and dank area.  It is small; the only things here are an old chest and some wooden stairs leading up to a locked door.  You don't know how you managed to lock yourself in when you came down to get your book, but the important thing is the bus leaves soon, so you'd better get out of here soon.

You can see a chest (closed) here.

>open chest
You open the chest, revealing a spell book and a flute.

>take book
Taken.

>take flute
Taken.

>cdefg
You play a simple scale on your flute.
You hear a click from just above you.  Looking up, you see that the basement door has somehow come unlocked.

>u
(first opening the basement door)

Living Room
Your living room is a long room with a small table, a couple of chairs, and a painting.  The basement is below you.  A hallway in the north leads to the kitchen.  The front door is open on the east side of the room.

>e
You make it to the bus stop just as the bus pulls up.

Street
The bus stop is right in front of your house.

You can see a bus sign and a bus here.

>get in bus
You get on the bus and sit in the back.  Before you know it, you are getting off at the entrance to school.

School Entrance
The entrance to school is just a parking lot with a sign stating the name of your school.  The rest of your classmates are already entering the quad.  You see Jane among them.  You have to catch up to her and ask her to the dance tonight before someone else does.  The quad is just to the north.

>n
Quad
The quad is a great grassy square with the computer lab to the west, the science building to the north, the school gym to the east, and the parking lot to the south.  Students are bustling all over the place.  The Math, English, Social Studies, and Language buildings are behind the science building, but you don't have any of those classes today.  You see Jane walking into the computer lab.  You both have computer science there in ten minutes.

You can see a flowers and a hooded man here.

>w
You have some time to kill.  Why not look around the quad a bit?

>take flowers
Good idea!  You can give these to Jane when you ask her to the dance.

>write cdeee
You scribble the word "CDEEE" into your spell book, along with the words "From the hooded man".

Look at that!  It's time for computer science.

>w
Computer Lab
The computer lab is a small, square-shaped room with rows of desks facing the northern wall.  Each desk has a computer on it.

You can see Jane here.

You step into the computer lab just as class begins.  Jane, your crush, is already sitting down.
"Good morning, class," the teacher says, "Today, we will be working on our text-adventure games."
• • •
"Remember, games are due next class," the teacher concludes.  Everyone begins to pack up their backpacks and leave.  Jane is leaving, too.  You have to stop her so you can ask her to the dance!

>cdeee
You play the tune you heard the hooded man whistling on your flute.
A sudden downpour comes down, soaking everyone in the quad.

It worked!  Jane stopped.  She seems to be waiting to see if the rain will stop.

>ask jane about danc
There is no reply.

>ask jane about dance
You approach her cautiously and tap her on the shoulder.  As you do so, you realize that you need to go to the bathroom.  You've got to be joking!  It's too late now.  Jane is already turning around.  You'll just have to hold it.

"Hi, Jane," you mutter nervously.  "Crazy weather, huh?"
"Yeah, it sure is.  Almost magical," she replies.  "Don't you just love the rain?"

>yes
"It's amazing if you think about it," she continues, "Tons and tons of liquid water rushing down from the sky and flowing down rivers."

Her words painfully remind you that you have to pee.

You really need to go to the bathroom.

"Well, anyway," you stammer, "I was just… I wanted to…"
You can't quite remember your train of thought.  This isn't good.  You're looking bad in front of Jane.  You start sweating violently.  Also not good.
"Is is hot in here, or is it just me?" you ask.
"I have some water, if you want," offers Jane.

>yes
She pulls a water bottle out of her backpack and hands it to you.  You waterfall a sizable gulp, into your mouth, much to your bladder's protest.

You bounce up and down nervously.  You can't hold it much longer.

"So, there's the dance tonight…" you begin uneasily.
"Oh, yeah!" Jane says, "Did you know the theme is underwater?

>no
"I heard they're going to have fish tanks and water sound effects and waterfalls," she explains.

Waterfalls are not fun to think about when you have to pee.

You can't hold it any longer!  You run to the bathroom without hesitation.  How embarrassing.

Just another day in the life of a teenage wizard.

    *** You have failed to get a date to the dance. ***

Would you like to RESTART, RESTORE a saved game, QUIT or UNDO the last command?

>undo
Computer Lab
[Previous turn undone.]

* * *

>teleport
That's not a verb I recognise.

>telepurt
Science Building
The science building is a large open area with doors to classrooms all around.  Your class is upstairs in the chemistry lab.

>s
Quad
The quad is a great grassy square with the computer lab to the west, the science building to the north, the school gym to the east, and the road to the south.  Students are bustling all over the place.  The Math, English, Social Studies, and Language buildings are behind the science building, but you don't have any of those classes today.  You see Jane walking into the computer lab.  You both have computer science there in ten minutes.

You can see a flowers and a hooded man here.

>talk to hooded man
You try to get the attention of the hooded man.  He ignores you and continues whistling.

* * *

>take friend
You can't see any such thing.

* * *

>dust chest
You clear the dust off of the surface of the chest.

>x chest
The chest is incredibly old-looking.  Now that the dust is gone, you can see that it is made primarily of some silver metal.

* * *

>play cdeee
You play the tune you heard the hooded man whistling on your flute.
  A sudden downpour comes down, soaking everyone in the quad.
Maybe you should write this down.

>play cdeee
You play the tune you heard the hooded man whistling on your flute.
  Nothing happens.  The rain will probably stop on it's own.

>z
Time passes.

>z
Time passes.

>z
Time passes.

The rain has stopped.

>z
Time passes.

>play cdeee
You play the tune you heard the hooded man whistling on your flute.
  A sudden downpour comes down, soaking everyone in the quad.

It worked!  Jane stopped.  She seems to be waiting to see if the rain will stop.

>z
Time passes.

The rain has stopped.

* * *

>z
Time passes.

>play cdeee
You play the tune you heard the hooded man whistling on your flute.
  A sudden downpour comes down, soaking everyone in the quad.

It worked!  Jane stopped.  She seems to be waiting to see if the rain will stop.

The rain has stopped.

>play cdeee
You play the tune you heard the hooded man whistling on your flute.
  A sudden downpour comes down, soaking everyone in the quad.

It worked!  Jane stopped.  She seems to be waiting to see if the rain will stop.

>z
Time passes.

* * *

>play cdeee
You play the tune you heard the hooded man whistling on your flute.
  A sudden downpour comes down, soaking everyone in the quad.
Maybe you should write this down.

>write down cdeee
You scribble the word "cdeee" into your spell book, along with the words "From the hooded man".

Look at that!  It's time for computer science.

* * *

>play cdeee
You play the tune you heard the hooded man whistling on your flute.
  A sudden downpour comes down, soaking everyone in the quad.
Maybe you should write this down.

>z
Time passes.

The rain has stopped.

* * *

>z
Time passes.

>play cdeee
You play the tune you heard the hooded man whistling on your flute.
  Nothing happens.  The rain will probably stop on it's own.

* * *

>z
Time passes.

The rain has stopped.

>play cdeee
You play the tune you heard the hooded man whistling on your flute.
  A sudden downpour comes down, soaking everyone in the quad.

It worked!  Jane stopped.  She seems to be waiting to see if the rain will stop.

* * *

>z
Time passes.

The rain has stopped.

>open chest
You open the chest, revealing a spell book and a flute.

* * *

>take flute
Taken.

>play cdefg
You play a simple scale on your flute.
You hear a click from just above you.  Looking up, you see that the basement door has somehow come unlocked.

>u
(first opening the basement door)

Living Room
Your living room is a long room with a small table, a couple of chairs, and a painting.  The basement is below you.  A hallway in the north leads to the kitchen.

>e
You make it to the bus stop just as the bus pulls up.

Street
The bus stop is right in front of your house.

You can see a bus sign and a bus here.

>get in bus
You get on the bus and sit in the back.  Before you know it, you are getting off at the entrance to school.

School Entrance
The entrance to school is just a parking lot with a sign stating the name of your school.  The rest of your classmates are walking to class already.  You see Jane among them.  You have to ask her to the dance tonight before someone else does.  The quad is just to the north.

>n
Quad
The quad is a great grassy square with the computer lab to the west, the science building to the north, the school gym to the east, and the road to the south.  The Math, English, Social Studies, and Language buildings are behind the science building, but you don't have any of those classes today.  You see Jane heading towards the computer lab.  You both have computer science there now.

You can see a flowers and a hooded man here.

>take flower
Taken.

>w
You step into the computer lab just as class begins.  Jane, your crush, is already sitting down.
"Good morning, class," the teacher says, "Today, we will be working on our text-adventure games…"

"Remember, games are due next class," the teacher concludes.  Everyone begins to pack up their backpacks and leave.  Jane is leaving, too.  You have to stop her so you can ask her to the dance!

Computer Lab
The computer lab is a small, square-shaped room with rows of desks facing the northern wall.  Each desk has a computer on it.

You can see Jane here.

>talk to jane
She's leaving in a big hurry.  You need to get her to stop first.

>play cdeee
You play the tune you heard the hooded man whistling on your flute.
  A sudden downpour comes down, soaking everyone in the quad.

It worked!  Jane stopped.  She seems to be waiting to see if the rain will stop.

>talk to jane
You approach her cautiously and tap her on the shoulder.  As you do so, you realize that you need to go to the bathroom.  You've got to be joking!  It's too late now.  Jane is already turning around.  You'll just have to hold it.

"Hi, Jane," you mutter nervously.  "Crazy weather, huh?"
"Yeah, it sure is.  Almost magical," she replies.  "Don't you just love the rain?"

>no
You have to go to the bathroom…

"Well, anyway," you stammer, "I was just… I wanted to…athrell, any"
You can't quite remember your train of thought.  This isn't good.  You're looking bad in front of Jane.  You start sweating violently.  Also not good.
"Is is hot in here, or is it just me?" you ask.
"I have some water, if you want," offers Jane.

>no
"No thank you," you say.

You have to go to the bathroom…饨

"So, there's the dance tonight…䁸ᅕ" you begin uneasily.
"Oh, yeah!" Jane says, "Did you know the theme is underwater?

>yes
"Seems a little cliché to me," she adds.

You have to go to the bathroom…⁥楌

"Do you have a date for that?" you inquire abruptly.
"Not yet," answers Jane, "If I don't get one soon, I'll probably just skip the dance and go whitewater rafting.  Have you ever been whitewater rafting?"

>yes
"Pretty fun, huh?" says Jane.

You have to go to the bathroom…

"Yeah… so, do you want to come to the dance with me?he湡⹥ਊthroom…" you blurt out.
"Oh.  Really?  Well…耀ays Jane.

Yo

Yo

Yo

Yo

Yo

Yo

Yo

Yo

Yo

Yo

Yo

Y"

She's indecisive!  You should give her something to tip the scales.

The rain has stopped.

>give jane flowers
"Wow, thanks!" Jane exclaims.  "That's so sweet.  You know what?  I will go to the dance with you."
She turns and walks out into the rain, and then sprints off towards the Math building.  Mission accompished: you have the perfect date to the dance.

>e
Quad
The quad is a great grassy square with the computer lab to the west, the science building to the north, the school gym to the east, and the road to the south.  

You can see a hooded man here.

>e
Gym
The gym is a large building with high windows.  As you approach it, you can already hear loud music coming out and lights flashing from inside.  You try to enter, but a large guard blocks your path.

You can see a guard here.

>w
Quad
The quad is a great grassy square with the computer lab to the west, the science building to the north, the school gym to the east, and the road to the south.  

You can see a hooded man here.

>e
Gym
The gym is a large building with high windows.  As you approach it, you can already hear loud music coming out and lights flashing from inside.

You can see a guard here.

>w
Quad
The quad is a great grassy square with the computer lab to the west, the science building to the north, the school gym to the east, and the road to the south.  

You can see a hooded man here.

* * *

>e
Gym
The gym is a large building with high windows.  As you approach it, you can already hear loud music coming out and lights flashing from inside.

You can see a guard here.

>e
Dance
You can see Jane here.

>talk to jane
    *** You have won ***

Would you like to RESTART, RESTORE a saved game, QUIT or UNDO the last command?

* * *

>play cdeee
You play the tune you heard the hooded man whistling on your flute.
  A sudden downpour comes down, soaking everyone in the quad.
Maybe you should write this down.

>open chest
You open the chest, revealing a spell book and a flute.

* * *

>take book
Taken.

>play cdeee
You play the tune you heard the hooded man whistling on your flute.
  Nothing happens.  The rain will probably stop on it's own.

* * *

>kiss chest
You can only do that to something animate.

>dust chest
You achieve nothing by this.

>clean chest
You achieve nothing by this.

* * *

>open all
You can't use multiple objects with that verb.

>open chest
You open the chest, revealing a spell book and a flute.

>take all
spell book: Taken.
flute: Taken.

>play cdefg
You play a simple scale on your flute.
You hear a click from just above you.  Looking up, you see that the basement door has somehow come unlocked.

>u
(first opening the basement door)

Living Room
Your living room is a long room with a small table, a couple of chairs, and a painting.  The basement is below you.  A hallway in the north leads to the kitchen.  The front door is open on the east side of the room.

* * *

>e
You make it to the bus stop just as the bus pulls up.

Street
The bus stop is right in front of your house.

You can see a bus sign and a bus here.

>get in bus
You get on the bus and sit in the back.  Before you know it, you are getting off at the entrance to school.

School Entrance
The entrance to school is just a parking lot with a sign stating the name of your school.  The rest of your classmates are walking to the quad already.  You see Jane among them.  You have to ask her to the dance tonight before someone else does.  The quad is just to the north.

>talk to jane
Everyone is rushing off to class.  You should be, too.

>x jae
You can't see any such thing.

>x jame
You can't see any such thing.

>x jane
From here, you recognize your friend, Todd, your lab partner, Kyle, and Jane, your crush.

>x Jane
From here, you recognize your friend, Todd, your lab partner, Kyle, and Jane, your crush.

>x classmates
From here, you recognize your friend, Todd, your lab partner, Kyle, and Jane, your crush.

>x road
The street is made of paved asphalt, and full of potholes.

>n
Quad
The quad is a great grassy square with the computer lab to the west, the science building to the north, the school gym to the east, and the road to the south.  Students are bustling all over the place.  The Math, English, Social Studies, and Language buildings are behind the science building, but you don't have any of those classes today.  You see Jane walking into the computer lab.  You both have computer science there in ten minutes.

You can see a flowers and a hooded man here.

>s
School Entrance
The entrance to school is just a parking lot with a sign stating the name of your school.  The quad is just to the north.

>x jane
From here, you recognize your friend, Todd, your lab partner, Kyle, and Jane, your crush.

>x road
The street is made of paved asphalt, and full of potholes.

>n
Quad
The quad is a great grassy square with the computer lab to the west, the science building to the north, the school gym to the east, and the road to the south.  Students are bustling all over the place.

You can see a flowers and a hooded man here.

>e
You don't want to go that way.  They're probably still setting up for the dance.  Just go to your class.

>n
You don't have class there.

>u
You can't go that way.

>w
You have some time to kill.

>x computer
You can't see any such thing.

>turn on computer
You can't see any such thing.

>l
Quad
The quad is a great grassy square with the computer lab to the west, the science building to the north, the school gym to the east, and the road to the south.  Students are bustling all over the place.

You can see a flowers and a hooded man here.

>take flowers
Taken.

>take hooded man
I don't suppose the hooded man would care for that.

>x hooded man
There is a man in a hooded cloak standing about the quad, whistling a strange tune.  The first three notes are similar to your unlocking spell, but then it repeats the last note twice.
You wonder if you should tell security about this guy.
Nah, he doesn't seem to be a threat.

>jump
You jump on the spot, fruitlessly.

>write down
I didn't understand that sentence.

>write down cdeee
You scribble the word "cdeee" into your spell book, along with the words "From the hooded man".

>x book
It is a mystic-looking leather-bound hand-sized book.The cover is embroidered with strange symbols that you don't understand.  Somehow, the book seems to eminate pure power.

>read book
It is a mystic-looking leather-bound hand-sized book.The cover is embroidered with strange symbols that you don't understand.  Somehow, the book seems to eminate pure power.
You should open the book if you want to read it.

>open book
You open the book.

>read book
The book says:

To unlock things:
cdefg

From the hooded man:
cdeee

>play cdeee
You play the tune you heard the hooded man whistling on your flute.
  A sudden downpour comes down, soaking everyone in the quad.

>w
You step into the computer lab just as class begins.  Jane, your crush, is already sitting down.
"Good morning, class," the teacher says, "Today, we will be working on our text-adventure games…"

"Remember, games are due next class," the teacher concludes.  Everyone begins to pack up their backpacks and leave.  Jane is leaving, too.  You have to stop her so you can ask her to the dance!
The rain has stopped.

Computer Lab
The computer lab is a small, square-shaped room with rows of desks facing the northern wall.  Each desk has a computer on it.

You can see Jane here.

>talk to jane
She's leaving in a big hurry.  You need to get her to stop first.

* * *

>talk to jane
You approach her cautiously and tap her on the shoulder.  As you do so, you realize that you need to go to the bathroom.  You've got to be joking!  It's too late now.  Jane is already turning around.  You'll just have to hold it.

"Hi, Jane," you mutter nervously.  "Crazy weather, huh?"
"Yeah, it sure is.  Almost magical," she replies.  "Don't you just love the rain?"

>no
You have to go to the bathroom…

"Well, anyway," you stammer, "I was just… I wanted to…

"W

"W

"W

"W

"W

"W

"W

"W

"W

"W

"W

"W

"W

"W

"W"
You can't quite remember your train of thought.  This isn't good.  You're looking bad in front of Jane.  You start sweating violently.  Also not good.
"Is is hot in here, or is it just me?" you ask.
"I have some water, if you want," offers Jane.

>okay
Please answer yes or no.

>yes
She pulls a water bottle out of her backpack and hands it to you.  You waterfall a sizable gulp, into your mouth, much to your bladder's protest.

You really need to go to the bathroom.

"So, there's the dance tonight…" you begin uneasily.
"Oh, yeah!" Jane says, "Did you know the theme is underwater?

>no
"I heard they're going to have fish tanks and water sound effects and waterfalls," she explains.

Waterfalls are not fun to think about when you have to pee.

You bounce up and down nervously.  You can't hold it much longer.  Jane looks at you funny.

"Do you have a date for that?" you inquire abruptly.
"Not yet," answers Jane, "If I don't get one soon, I'll probably just skip the dance and go whitewater rafting.  Have you ever been whitewater rafting?"

>yes
"Pretty fun, huh?" says Jane.

You bounce up and down nervously.  You can't hold it much longer.  Jane looks at you funny.

"Yeah… so, do you want to come to the dance with me?退slyਊ.  You can" you blurt out.
"Oh.  Really?  Well…湵祮 to the dance with me?退slyਊ.  You can"

She's indecisive!  You should give her something to tip the scales.

>give jane flowers
"Wow, thanks!" Jane exclaims.  "That's so sweet.  You know what?  I will go to the dance with you.  I'll meet you at the gym around seven."
She turns and walks out into the rain, and then sprints off towards the Math building.  Mission accompished: you have the perfect date to the dance.

Your next class is Chemistry.

The rain has stopped.

>follow jane
You can't see any such thing.

>e
Quad
The quad is a great grassy square with the computer lab to the west, the science building to the north, the school gym to the east, and the road to the south.  Students are bustling all over the place.

You can see a hooded man here.

>punch man
Violence isn't the answer to this one.

>n
Science Building
The science building is a large open area with doors to classrooms all around.  Your class is upstairs in the chemistry lab.

>x walls
The walls here have safety posters on them.

>x posters
The posters are mostly of celebrities like Smily Cyprus and Jason Biever telling you to be safe in science.

>u
Chemistry Lab
The chemistry lab is a large room full of beakers and test tubes on racks.  There is a whiteboard on one side of the room and a large window on the other.  The teacher isn't here, yet.

You can see Kyle here.

>talk to kyle
Kyle looks stressed.  You ask him what's wrong.
"What, you don't remember?" he asks.  "Our quarter exam is today!"  As he says it, he is pulling out his book and trying to cram.
Oh, no!  You completely forgot!  You can't afford to flunk this test.  You need to stop it from happening…汹⁥潬歯⁳瑳敲獳

>x kyle
Kyle has black hair, is slight of build, and looks very stressed.

>l
Chemistry Lab
The chemistry lab is a large room full of beakers and test tubes on racks.  There is a whiteboard on one side of the room and a large window on the other.  The teacher isn't here, yet.

You can see Kyle here.

>x whiteboard
The whiteboard is covered in diagrams and equations.  You don't understand any of it.

Through the window you can see your chemistry teacher, Mr Lacimec, approaching the building.

>x equations
The whiteboard is covered in diagrams and equations.  You don't understand any of it.

>x window
Through the window, you can see your chemistry teacher, Mr Lacimec.

Mr Lacimec is approaching the building.

>x chemicals
The test tubes and beakers are of all different shapes and sizes, and all kinds of chemicals sit inside them.

>take chemicals
You pick up a test tube and drink it's contents.  You take a beaker of powder and consume that, too.
You don't feel so well…u take a beaker of powder and 

    *** You have exploded. ***

Would you like to RESTART, RESTORE a saved game, QUIT or UNDO the last command?

>undo
Chemistry Lab
[Previous turn undone.]

>x mr lacimec
Mr Lacimec is walking towards the science building with his waterproof breifcase in one hand and his coasters in his pocket.  He is smiling.  Or is that an evil grin?

>x coasters
Mr Lacimec always carries coasters with him.  You know how he hates paper getting wet.

Mr Lacimec is nearly at the building.

>play cdeee
You play the tune you heard the hooded man whistling on your flute.
  A sudden downpour comes down, soaking everyone in the quad.
Through the window, you notice Mr Lacimec continue walking seemingly undeterred by the rain.

>x briefcase
The briefcase is small, silver, and rectangular.  The big bronze latch on top is in the locked position.

>play cdefg
You play a simple scale on your flute.
Through the window, you notice Mr Lacimec's briefcase magicly unlatch itself and fall open.  Papers from within the briefcase go flying everywhere.
The test paper immediately get soaked by the rain.  When Mr Lacimec gets to the classroom, he is not happy.  The entire class spends the rest of class sitting in the corner.  At least you're not failing.
By the time class is over, the sun is beginning to set, and it is late in the day.  It's time to go to the dance with Jane.  She should be waiting at the gym right now.

Quad
The quad is a great grassy square with the computer lab to the west, the science building to the north, the school gym to the east, and the road to the south.  Students are bustling all over the place.  It is raining hard.

You can see a hooded man here.

>z
Time passes.

>x hooded man
There is a man in a hooded cloak standing about the quad, whistling a strange tune.  The first three notes are similar to your unlocking spell, but then it repeats the last note twice.

>x hooded man
There is a man in a hooded cloak standing about the quad, whistling a strange tune.  The first three notes are similar to your unlocking spell, but then it repeats the last note twice.

The rain has stopped.

>talk to man
You try to get the attention of the hooded man.  He ignores you and continues whistling.

>e
You make your way east towards the gym.  You're so excited about dancing with Jane that you don't see the football flying through the air toward you.
*POW*

By the time you wake up, it is well into the dance.  Jane probably is wondering where you are.  You need to get in there now!

Gym
The gym is a large building with high windows.  As you approach it from the west, you can already hear loud music coming out and lights flashing from inside.  You try to enter, but a large guard blocks your path.

You can see a guard here.

>x guard
A chubby, but tall senior stands in front of the door, blocking your entrance.  He wears a shirt with a donut on it.

>x shirt
The senior's shirt features a chocolate donut with a bite out of it.  He must really like donuts.

>talk to guard
"Sorry, pal.  You were late to the dance, and it's my job to make sure no one enters or leaves this dance between the hours of five minutes ago and when they tell me to leave.  I'm getting paid to stand here."

>e
The guard steps in front of you.
"No can do, buddy," he says, "I'm afraid you're late.  The dance has already started."

>ask guard to leave
I didn't understand that sentence.

>ask guard about money
"I'm getting paid fifty dollars to stand here and keep latecomers like you out.  You're not getting into this dance."

>l
Gym
The gym is a large building with high windows.  As you approach it from the west, you can already hear loud music coming out and lights flashing from inside.

You can see a guard here.

>take donut
You can't see any such thing.

>i
You're carrying a flute and a spell book.  You are also wearing a backpack.

>x backpack
Your backpack is black and weighed down with all of your school books.  Your shoulders ache from wearing it.
It is closed.

>open backpack
You open the backpack, revealing a schoolbooks and a note.

>take books
Taken.

>take schoolbooks
You already have that.

>x books
Trigonometry, Chemistry, Spanish… your backpack is loaded with heavy textbooks.

>open textbooks
Those aren't going to help you right now.

>take note
Taken.

>x note
This is the note Dad put on your backpack when he left this morning before you woke up.  It reads:

Hey, sport,
I went down to the coffee shop to get my donut with my Decaf.  I won't see you untill after school.
Don't forget your flute!
-Dad

>decaf
That's not a verb I recognise.

>write decaf
You scribble the word "Decaf" into your spell book.

>play decaf on flute
You play an odd-sounding melody on the flute.
*Poof!*
A donut appears in your hand!

>i
You're carrying a note, a schoolbooks, a flute and a spell book and 1 donut.  You are also wearing a backpack.

>offer guard donut
(first taking the donut)
You pull out a donut and hand it to him.  His eyes widen.
"You can only have it if you let me in," you say alluringly.
"Deal!" he exlaims without hesitation.  "They're only paying me fifty bucks, anyway."

The guard steps aside to let you through.

>play decaf
You play an odd-sounding melody on the flute.
*Poof!*
A donut appears in your hand!

>give guard decaf
You can't see any such thing.

>give guard donut
You can't see any such thing.

>i
You're carrying a note, a schoolbooks, a flute and a spell book and 1 donut.  You are also wearing a backpack.

>eat donut
(first taking the donut)
You devour the donut in no time.  Delicious!

>l
Gym
The gym is a large building with high windows.  As you approach it from the west, you can already hear loud music coming out and lights flashing from inside.

>take donut
You can't see any such thing.

>play decaf
You play an odd-sounding melody on the flute.
*Poof!*
A donut appears in your hand!

* * *

>e
Dance
Loud music fills your ears as you walk into the dance.  Through the thick mass of bodies and dim light, you can see Jane socializing with her friend.

You can see Jane here.

>listen to music
You hear nothing unexpected.

>x bodies
These people are bouncing to and fro as a single entity.  They are no longer human in their minds.

>dance
You start dancing around by yourself.  Who needs a date?
You leave that dance with a renewed confidence in yourself, fully prepared to live the rest of your life in solitude.

    *** You have won ***

Would you like to RESTART, RESTORE a saved game, QUIT or UNDO the last command?

>undo
Dance
[Previous turn undone.]

>talk to jane
You tap Jane on the shoulder.  She seems glad to see you.  You have the most amazing night of your life, you and Jane have a long happy relationship, and you live happily ever after.
Just another day in the life of a teenage wizard.

    *** You have won ***

Would you like to RESTART, RESTORE a saved game, QUIT or UNDO the last command?

>undo
Dance
[Previous turn undone.]

>l
Dance
Loud music fills your ears as you walk into the dance.  Through the thick mass of bodies and dim light, you can see Jane socializing with her friend.

You can see Jane here.

>x friend
Jane's friend is tall and blonde.  She and Jane are talking to each other.

>talk to friend
You tap Jane's friend on the shoulder.
"Hi, how are you?  Are you friends with Jane?" you ask loudly.
"What?" she replies, "what do you mean, my gargoyles are spitting?"
"Why, no, I don't want a purple monkey grinder," you say back.
"Don't you think people would notice a giant singing organ?" points out Jane's friend.
"Why are we talking about poisonous holes in the uniforms?"
"What?"
"Never mind."
"What?"
"What?"
"Okay."
"Fine, then."

>kiss friend
You spin Jane's friend around and kiss her.  Jane notices, yanks you two apart, and yells at you.  You can't hear what she's saying over the loud music, but she gets very animated.  You decide to ignore her and continue kissing her friend.
Then, a boy comes over, pushes you apart, and yells at you.  You can't hear him, either, but it seems to be something along the lines of "That's my girlfriend."
Suddenly, you recognize him as the guy who won the world boxing championships last year.  Uh-oh.

    *** You have died ***

Would you like to RESTART, RESTORE a saved game, QUIT or UNDO the last command?

>undo
Dance
[Previous turn undone.]

>dance with jane
You take Jane's hands and dance the night away with her.
Congratulations!  You successfully managed to get to school on time, avoid flunking Chemistry, and get a date to the dance.
Just another day in the life of a teenage wizard.
You take Jane's hands and spin them around in a ballroom dance.
Jane punches you in the face.

    *** You have won ***

Would you like to RESTART, RESTORE a saved game, QUIT or UNDO the last command?

>undo
Dance
[Previous turn undone.]

>dance with friend
You take Jane's friend in your arms and dance with her.  You don't recognize her.  She must not go to your school, because she's way prettier than Jane.  You both fall in love.
Now you have a date even better than Jane.  Score!

    *** You have won ***

Would you like to RESTART, RESTORE a saved game, QUIT or UNDO the last command?

* * *

>open ches
There is no such thing here.  You must be hallucinating.

>open chest
You open the chest, revealing a spell book and a flute.

* * *

>x ceiling
You can't see any such thing.

>x ceiling
You can't see any such thing.

>x walls
You can't see any such thing.

>x floor
You can't see any such thing.

>open chest
You open the chest, revealing a spell book and a flute.

>take flute
Taken.

>take book
Taken.

>play cdefg
You play a simple scale on your flute.
You hear a click from just above you.  Looking up, you see that the basement door has somehow come unlocked.

* * *

>u
(first opening the basement door)

Living Room
Your living room is a long room with a small table, a couple of chairs, and a painting.  The basement is below you.  A hallway in the north leads to the kitchen.

>n
You're not feeling very hungry right now.

>e
You make it to the bus stop just as the bus pulls up.

Street
The bus stop is right in front of your house.

You can see a bus sign and a bus here.

* * *

>n
Quad
The quad is a great grassy square with the computer lab to the west, the science building to the north, the school gym to the east, and the road to the south.  The Math, English, Social Studies, and Language buildings are behind the science building, but you don't have any of those classes today.  You see Jane heading towards the computer lab.  You both have computer science there now.

You can see a flowers and a hooded man here.

>w
You step into the computer lab just as class begins.  Jane, your crush, is already sitting down.
"Good morning, class," the teacher says, "Today, we will be working on our text-adventure games…Ja"

"Remember, games are due next class," the teacher concludes.  Everyone begins to pack up their backpacks and leave.  Jane is leaving, too.  You have to stop her so you can ask her to the dance!

Computer Lab
The computer lab is a small, square-shaped room with rows of desks facing the northern wall.  Each desk has a computer on it.

You can see Jane here.

>x ceiling
The ceiling here is white and bare.

>x floor
The floor is made of cold white tiles.

>x walls
The walls here are white and bare.

>e
Quad
The quad is a great grassy square with the computer lab to the west, the science building to the north, the school gym to the east, and the road to the south.  

You can see a flowers and a hooded man here.

>x jesus
You can't see any such thing.

>w
Computer Lab
The computer lab is a small, square-shaped room with rows of desks facing the northern wall.  Each desk has a computer on it.

You can see Jane here.

>e
Quad
The quad is a great grassy square with the computer lab to the west, the science building to the north, the school gym to the east, and the road to the south.  

You can see a flowers and a hooded man here.

>e
Gym
The gym is a large building with high windows.  As you approach it, you can already hear loud music coming out and lights flashing from inside.  You try to enter, but a large guard blocks your path.

You can see a guard here.

>e
Dance

>w
Gym
The gym is a large building with high windows.  As you approach it, you can already hear loud music coming out and lights flashing from inside.

You can see a guard here.

>give guard donut
(first taking the donut)
You can't see any such thing.

>eat donut
(first taking the donut)
Hah!  You wish you could eat a donut right now!

>play Decaf
You play an odd-sounding melody on the flute.
*Poof!*
A donut appears in your hand!

>eat donut
(first taking the donut)
You devour the donut in no time.  Delicious!

>w
Quad
The quad is a great grassy square with the computer lab to the west, the science building to the north, the school gym to the east, and the road to the south.  

You can see a flowers and a hooded man here.

>give donut to man
You can only do that to something animate.

>e
Gym
The gym is a large building with high windows.  As you approach it, you can already hear loud music coming out and lights flashing from inside.

You can see a guard here.

>play decaf
You play an odd-sounding melody on the flute.
*Poof!*
A donut appears in your hand!

>give guard donut
(first taking the donut)
You pull out a donut and hand it to him.  His eyes widen.
"You can only have it if you let me in," you say alluringly.
"Deal!" he exlaims without hesitation.  "They're only paying me fifty bucks, anyway."

The guard steps aside to let you through.

>undo
Gym
[Previous turn undone.]

>give donut to guard
(first taking the donut)
You pull out a donut and hand it to him.  His eyes widen.
"You can only have it if you let me in," you say alluringly.
"Deal!" he exlaims without hesitation.  "They're only paying me fifty bucks, anyway."

The guard steps aside to let you through.

>e
Dance

>w
Gym
The gym is a large building with high windows.  As you approach it, you can already hear loud music coming out and lights flashing from inside.

>w
Quad
The quad is a great grassy square with the computer lab to the west, the science building to the north, the school gym to the east, and the road to the south.  

You can see a flowers and a hooded man here.

>w
Computer Lab
The computer lab is a small, square-shaped room with rows of desks facing the northern wall.  Each desk has a computer on it.

You can see Jane here.

>talk to jane
She's leaving in a big hurry.  You need to get her to stop first.

>play cdeee
You play the tune you heard the hooded man whistling on your flute.
  A sudden downpour comes down, soaking everyone in the quad.

It worked!  Jane stopped.  She seems to be waiting to see if the rain will stop.

The rain has stopped.

* * *

>talk to jane
You approach her cautiously and tap her on the shoulder.  As you do so, you realize that you need to go to the bathroom.  You've got to be joking!  It's too late now.  Jane is already turning around.  You'll just have to hold it.

"Hi, Jane," you mutter nervously.  "Crazy weather, huh?"
"Yeah, it sure is.  Almost magical," she replies.  "Don't you just love the rain?"

>no
You have to go to the bathroom…

"Well, anyway," you stammer, "I was just… I wanted to…

"W

"W

"W

"W

"W

"W

"W

"W

"W

"W

"W

"W

"W

"W

"W

"W

"W

"W

"W

"W

"W"
You can't quite remember your train of thought.  This isn't good.  You're looking bad in front of Jane.  You start sweating violently.  Also not good.
"Is is hot in here, or is it just me?" you ask.
"I have some water, if you want," offers Jane.

>no
"No thank you," you say.

You have to go to the bathroom…

"So, there's the dance tonight…" you begin uneasily.
"Oh, yeah!" Jane says, "Did you know the theme is underwater?

>yes
"Seems a little cliché to me," she adds.

You have to go to the bathroom…걡

"Do you have a date for that?" you inquire abruptly.
"Not yet," answers Jane, "If I don't get one soon, I'll probably just skip the dance and go whitewater rafting.  Have you ever been whitewater rafting?"

>yes
"Pretty fun, huh?" says Jane.

You have to go to the bathroom…饨

"Yeah… so, do you want to come to the dance with me?겊約湡⹥ਊthroom…饨" you blurt out.
"Oh.  Really?  Well…e "

She's indecisive!  You should give her something to tip the scales.

The rain has stopped.

>w
You can't go that way.

>e
You bailed on Jane before she could make a decision!  She probably thinks you're a jerk now.  Nice going, you horrible person.

    *** You have lost. ***

Would you like to RESTART, RESTORE a saved game, QUIT or UNDO the last command?

>undo
Computer Lab
[Previous turn undone.]

>undo
Computer Lab
[Previous turn undone.]

>e
You bailed on Jane before she could make a decision!  She probably thinks you're a jerk now.  Nice going, you horrible person.

    *** You have lost. ***

Would you like to RESTART, RESTORE a saved game, QUIT or UNDO the last command?

* * *

>undo
Computer Lab
[Previous turn undone.]

>e
Quad
The quad is a great grassy square with the computer lab to the west, the science building to the north, the school gym to the east, and the road to the south.  

You can see a flowers and a hooded man here.

>take flowers
Taken.

>w
Computer Lab
The computer lab is a small, square-shaped room with rows of desks facing the northern wall.  Each desk has a computer on it.

You can see Jane here.

* * *

>test me
>--> No test scripts exist for this game.

>test me
>--> No test scripts exist for this game.

>what is a test script
I don't understand that action.

>open chest
You open the chest, revealing a spell book and a flute.

>take book and flute
spell book: Taken.
flute: Taken.

>cdefg
You play a simple scale on your flute.
You hear a click from just above you.  Looking up, you see that the basement door has somehow come unlocked.

* * *

>n
Quad
The quad is a great grassy square with the computer lab to the west, the science building to the north, the school gym to the east, and the parking lot to the south.  Students are bustling all over the place.  The Math, English, Social Studies, and Language buildings are behind the science building, but you don't have any of those classes today.  You see Jane walking into the computer lab.  You both have computer science there in ten minutes.

You can see a flowers and a hooded man here.

>talke to hooded man
I don't understand that action.

>x man
There is a man in a hooded cloak standing about the quad, whistling a strange tune.  The first three notes are similar to your unlocking spell, but then it repeats the third note two more times.
You wonder if you should tell security about this guy.
Nah, he doesn't seem to be a threat.

>write cdeee
You scribble the word "CDEEE" into your spell book, along with the words "From the hooded man".

>pick flowers
Good idea!  You can give these to Jane when you ask her to the dance.

Look at that!  It's time for computer science.

>w
Computer Lab
The computer lab is a small, square-shaped room with rows of desks facing the northern wall.  Each desk has a computer on it.

You can see Jane here.

You step into the computer lab just as class begins.  Jane, your crush, is already sitting down.
"Good morning, class," the teacher says, "Today, we will be working on our text-adventure games."
• • •
"Remember, games are due next class," the teacher concludes.  Everyone begins to pack up their backpacks and leave.  Jane is leaving, too.  You have to stop her so you can ask her to the dance!

>stop jane
How do you intend to do that?  She's leaving in such a big hurry, she probably won't notice you.

>cdeee
You play the tune you heard the hooded man whistling on your flute.
A sudden downpour comes down, soaking everyone in the quad.

It worked!  Jane stopped.  She seems to be waiting to see if the rain will stop.

>talk to jane
You approach her cautiously and tap her on the shoulder.  As you do so, you realize that you need to go to the bathroom.  You've got to be joking!  It's too late now.  Jane is already turning around.  You'll just have to hold it.

"Hi, Jane," you mutter nervously.  "Crazy weather, huh?"
"Yeah, it sure is.  Almost magical," she replies.  "Don't you just love the rain?"

>yes
"It's amazing if you think about it," she continues, "Tons and tons of liquid water rushing down from the sky and flowing down rivers."

Her words painfully remind you that you have to pee.

You really need to go to the bathroom.

"Well, anyway," you stammer, "I was just… I wanted to…"
You can't quite remember your train of thought.  This isn't good.  You're looking bad in front of Jane.  You start sweating violently.  Also not good.
"Is is hot in here, or is it just me?" you ask.
"I have some water, if you want," offers Jane.

* * *

>no
"I heard they're going to have fish tanks and water sound effects and waterfalls," she explains.

Waterfalls are not fun to think about when you have to pee.

You can't hold it any longer!  You run to the bathroom without hesitation.  How embarrassing.

Just another day in the life of a teenage wizard.

    *** You have failed to get a date to the dance. ***

Would you like to RESTART, RESTORE a saved game, QUIT or UNDO the last command?

>yes
Please give one of the answers above.

Would you like to RESTART, RESTORE a saved game, QUIT or UNDO the last command?

>undo
Computer Lab
[Previous turn undone.]

>talk to jane
You approach her cautiously and tap her on the shoulder.  As you do so, you realize that you need to go to the bathroom.  You've got to be joking!  It's too late now.  Jane is already turning around.  You'll just have to hold it.

"Hi, Jane," you mutter nervously.  "Crazy weather, huh?"
"Yeah, it sure is.  Almost magical," she replies.  "Don't you just love the rain?"

* * *

>undo
Computer Lab
[Previous turn undone.]

>no
That was a rhetorical question.

>undo
Computer Lab
[Previous turn undone.]

>ask jane about dance
There is no reply.

The rain has stopped.

>yes
That was a rhetorical question.

>yes
That was a rhetorical question.

>no
That was a rhetorical question.