You're practically ripping out your hair from stress.  Today is the date of the school dance, which you still don't have a date for.  To make matters worse, there's the major chemistry exam worth 40% of your grade that you haven't studied for yet.  On top of that, you're already late for school.  Oh, yeah, and you're locked in the basement.

A Day in the Life of a Teenage Wizard
Ordinary Problems, Magical Solutions by Justin Kunimune
Release 1 / Serial number 131007 / Inform 7 build 6G60 (I6/v6.32 lib 6/12N) SD

Basement
The basement is a dark and dank area.  It is small; the only things here are an old chest and some wooden stairs leading up to an unlocked door.  You don't know how you managed to lock yourself in when you came down to get your book, but the important thing is the bus leaves in 10 minutes, so you'd better get out of here soon.

You can see a chest (closed) here.

>u
(first opening the basement door)
It seems to be locked.

>open chest
You open the chest, revealing a spell book and a flute.

* * *

>take book
Taken.

>open book
You open the book.

>x book
It is a mystic-looking leather-bound hand-sized book.It is open.  The pages inside are mostly covered in blank musical staffs, but the first page has a brief melody recorded with a title.  Somehow, the book seems to eminate pure power.

>read book
The book says:

To unlock things:
abcde

>play abcde
You play a simple scale on your flute.
You hear a click from just above you.  Looking up, you see that the basement door has somehow come unlocked.

>u
(first opening the basement door)

Living Room
You can see the basement door here.

>d
Basement
The basement is a dark and dank area.  It is small; the only things here are an old chest and some wooden stairs leading up to a locked door.

You can see the basement door and a chest (empty) here.

>l
Basement
The basement is a dark and dank area.  It is small; the only things here are an old chest and some wooden stairs leading up to a locked door.

You can see the basement door and a chest (empty) here.

>u
Living Room
You can see the basement door here.

>ne
You can't go that way.

>n
Kitchen

>s
Living Room
You can see the basement door here.

>e
Street

>e
School Entrance

>n
Quad

>n
Science Building

>u
Chemistry Lab

>d
Science Building

>s
Quad

>w
Computer Lab

>e
Quad

>e
Gym

>e
Dance

* * *

>dust chest
You achieve nothing by this.

>brush the dsut off of the chest
That's not a verb I recognise.

* * *

>x basement door
You see nothing special about the basement door.

>u
(first opening the basement door)
It seems to be locked.

* * *

>open chest
You open the chest, revealing a spell book and a flute.

* * *

>play cdefg
You play a simple scale on your flute.
You hear a click from just above you.  Looking up, you see that the basement door has somehow come unlocked.

>u
(first opening the basement door)

Living Room

>e
Street

* * *

>e
School Entrance

>n
Quad
The quad is a great grassy square with the computer lab to the west, the science building to the north, the school gym to the east, and the road to the south.  The Math, English, Social Studies, and Language buildings are behind the science building, but you don't have any of those classes today.

You can see a flowers and a hooded man here.

>w
You hurry into the computer lab building just as Computer Science starts.  Your crush, Jane, is here.  You have to remember to ask her to the dance before she leaves class.
"Today, we will be working on our text-based adventure games," begins the teacher…rk"

"Remember, games are due next class," says the teacher as class ends and everyone begins to pack up.  Your heart skips a beat as you realize Jane is leaving, also.  You need to get her to stay a little longer!

Computer Lab
The computer lab is a small, square-shaped room with rows of desks facing the northern wall.  Each desk has a computer on it.

You can see Jane here.

>x desk
The desks are made of rectangular pieces of wood, with thin metal legs.

>x desks
The desks are made of rectangular pieces of wood, with thin metal legs.

>x computers
The computers are fairly new.  They are turned off, but you probably shouldn't turn them on without the teacher here.  They are all Banana brand computers.

>play gfedc
You can't see any such thing.

>e
Quad
The quad is a great grassy square with the computer lab to the west, the science building to the north, the school gym to the east, and the road to the south.  The Math, English, Social Studies, and Language buildings are behind the science building, but you don't have any of those classes today.

You can see a flowers and a hooded man here.

>x hooded man
There is a man in a hooded cloak standing about the quad, whistling a strange tune.  The first three notes are similar to your unlocking spell, but then it repeats the last not twice.
You wonder if you should tell security about this guy.
Nah, he doesn't seem to be a threat.

>x flowers
These roses have a lovely aroma.  They sure seem romantic.  You could give these to Jane.

>put cdeee in book
You scribble the word "cdeee" into your spell book, along with the words "From the hooded man".

>put Decaf in book
You scribble the word "Decaf" into your spell book.

>take flowers
Taken.

>play cdeee
You play the tune you heard the hooded man whistling on your flute.
  A sudden downpour comes down, soaking everyone in the quad.

>read book
It is a mystic-looking leather-bound hand-sized book.The cover is embroidered with strange symbols that you don't understand.  Somehow, the book seems to eminate pure power.

>read book
It is a mystic-looking leather-bound hand-sized book.The cover is embroidered with strange symbols that you don't understand.  Somehow, the book seems to eminate pure power.

>open book
You open the book.

>read book
The book says:

To unlock things:
cdefg

Decaf

From the hooded man:
cdeee

>play cdeee
You play the tune you heard the hooded man whistling on your flute.
  Nothing happens.  The rain will probably stop on it's own.

>l
Quad
The quad is a great grassy square with the computer lab to the west, the science building to the north, the school gym to the east, and the road to the south.  The Math, English, Social Studies, and Language buildings are behind the science building, but you don't have any of those classes today.  It is raining hard.

You can see a hooded man here.

>talk to hooded man
You try to get the attention of the hooded man.  He ignores you.

>w
Computer Lab
The computer lab is a small, square-shaped room with rows of desks facing the northern wall.  Each desk has a computer on it.

You can see Jane here.

>talk to jane
You approach her cautiously and tap her on the shoulder.  As you do so, you realize that you need to go to the bathroom.  Nice timing, bladder!  It's too late now.  Jane is already turning around.  You'll just have to hold it.

"Hi, Jane," you mutter nervously.  "Crazy weather, huh?"
"Yeah, it sure is.  Almost magical," she replies.  "Don't you just love the rain?"

>talk to computers
You strike up a conversation with the computers.  Weirdo.

>x me
You are a sixteen-year-old with dark hair and dark eyes.  You have a heavy-looking backpack on your back.

* * *

>take book
Taken.

>play abcde
You can't see any such thing.

>u
(first opening the basement door)
It seems to be locked.

>play abcde
You can't see any such thing.

>play cdefg
You play a simple scale on your flute.
You hear a click from just above you.  Looking up, you see that the basement door has somehow come unlocked.

* * *

>u
(first opening the basement door)

Living Room

>u
Second Floor

>d
Living Room

* * *

>take flute
Taken.

>put flute in backpack
The backpack is closed.

>take book
Taken.

>read book
The book says:

To unlock things:
abcde

>play flute
You play a charming melody on your flute.  The flute grows warm and seems to vibrate with energy--an energy almost magical.

>play abcde on flute
You play a simple scale on your flute.
You hear a click from just above you.  Looking up, you see that the basement door has somehow come unlocked.

>read book
The book says:

To unlock things:
abcde

>open book
You open the book.

>x book
The book says:

To unlock things:
abcde

>read book
The book says:

To unlock things:
abcde

>take book
You already have that.

>read book
The book says:

To unlock things:
abcde

* * *

>open book
You open the book.

>read book
The book says:

To unlock things:
abcde

>close book
You close the book.

>read book
The book says:

To unlock things:
abcde

>i
You are carrying:
  a spell book
  a flute
  a backpack (being worn and closed)

>x book
The book says:

To unlock things:
abcde

* * *

>x book
It is a mystic-looking leather-bound hand-sized book.It is open.  The pages inside are mostly covered in blank musical staffs, but the first page has a brief melody recorded with a title.  Somehow, the book seems to eminate pure power.

>read book
The book says:

To unlock things:
cdefg

>take flute
Taken.

* * *

>play cdefg
You play a simple scale on your flute.
You hear a click from just above you.  Looking up, you see that the basement door has somehow come unlocked.

>play Decaf
You play an odd-sounding melody on the flute.
*Poof!*
A donut appears in your hand!

>play decaf
You play an odd-sounding melody on the flute.
*Poof!*
A donut appears in your hand!

>i
You're carrying a flute and a spell book and 2 donuts.  You are wearing a backpack.

>take off backpack
You take off the backpack.

>i
You're carrying a flute, a spell book and a backpack and 2 donuts.

* * *

>n
Quad
The quad is a great grassy square with the computer lab to the west, the science building to the north, the school gym to the east, and the road to the south.  The Math, English, Social Studies, and Language buildings are behind the science building, but you don't have any of those classes today.

You can see a flowers and a hooded man here.

>take flowers
Taken.

>x hooded man
There is a man in a hooded cloak standing about the quad, whistling a strange tune.  The first three notes are similar to your unlocking spell, but then it repeats the last not twice.
You wonder if you should tell security about this guy.
Nah, he doesn't seem to be a threat.

>write cdeee
You scribble the word "cdeee" into your spell book, along with the words "From the hooded man".

>w
You hurry into the computer lab building just as Computer Science starts.  Your crush, Jane, is here.  You have to remember to ask her to the dance before she leaves class.
"Today, we will be working on our text-based adventure games," begins the teacher…rk"

"Remember, games are due next class," says the teacher as class ends and everyone begins to pack up.  Your heart skips a beat as you realize Jane is leaving, also.  You need to get her to stay a little longer!

Computer Lab
The computer lab is a small, square-shaped room with rows of desks facing the northern wall.  Each desk has a computer on it.

You can see Jane here.

>talk to jane
She's leaving in a big hurry.  You need to get her to stop first.

>play cdefg
You play a simple scale on your flute.

>play cdeee
You play the tune you heard the hooded man whistling on your flute.
  A sudden downpour comes down, soaking everyone in the quad.

>talk jane
I didn't understand that sentence.

>talk to jane
You approach her cautiously and tap her on the shoulder.  As you do so, you realize that you need to go to the bathroom.  You've got to be joking!  It's too late now.  Jane is already turning around.  You'll just have to hold it.

"Hi, Jane," you mutter nervously.  "Crazy weather, huh?"
"Yeah, it sure is.  Almost magical," she replies.  "Don't you just love the rain?"

>yes
"It's amazing if you think about it," she continues, "Tons and tons of liquid water rushing down from the sky and flowing down rivers."

Her words painfully remind you that you have to pee.

"Well, anyway," you stammer, "I was just… I wanted to…畮獥‬吢"
You can't quite remember your train of thought.  This isn't good.  You're looking bad in front of Jane.  You start sweating violently.  Also not good.
"Is is hot in here, or is it just me?" you ask.
"I have some water, if you want," offers Jane.

>yes
She pulls a water bottle out of her backpack and hands it to you.  You waterfall a sizable gulp, into your mouth, much to your bladder's protest.
"So, there's the dance tonight…" you begin uneasily.
"Oh, yeah!" Jane says, "Did you know the theme is underwater?

>undo
Please answer yes or no.

>no
"I heard they're going to have fish tanks and water sound effects and waterfalls," she explains.

Waterfalls are not fun to think about when you have to pee.

>talk to jane
You approach her cautiously and tap her on the shoulder.  As you do so, you realize that you need to go to the bathroom.  You've got to be joking!  It's too late now.  Jane is already turning around.  You'll just have to hold it.

"Hi, Jane," you mutter nervously.  "Crazy weather, huh?"
"Yeah, it sure is.  Almost magical," she replies.  "Don't you just love the rain?"

>e
Please answer yes or no.

>no
"Well, anyway," you stammer, "I was just… I wanted to…"
You can't quite remember your train of thought.  This isn't good.  You're looking bad in front of Jane.  You start sweating violently.  Also not good.
"Is is hot in here, or is it just me?" you ask.
"I have some water, if you want," offers Jane.

>no
"No thank you," you say.
"So, there's the dance tonight…" you begin uneasily.
"Oh, yeah!" Jane says, "Did you know the theme is underwater?

>yes
"Seems a little cliché to me," she adds.

* * *

>e
School Entrance

>e
You can't go that way.

>n
Quad
The quad is a great grassy square with the computer lab to the west, the science building to the north, the school gym to the east, and the road to the south.  The Math, English, Social Studies, and Language buildings are behind the science building, but you don't have any of those classes today.

You can see a flowers and a hooded man here.

>x man
There is a man in a hooded cloak standing about the quad, whistling a strange tune.  The first three notes are similar to your unlocking spell, but then it repeats the last not twice.
You wonder if you should tell security about this guy.
Nah, he doesn't seem to be a threat.

>take flowers
Taken.

>w
You hurry into the computer lab building just as Computer Science starts.  Your crush, Jane, is here.  You have to remember to ask her to the dance before she leaves class.
"Today, we will be working on our text-based adventure games," begins the teacher…"

"Remember, games are due next class," says the teacher as class ends and everyone begins to pack up.  Your heart skips a beat as you realize Jane is leaving, also.  You need to get her to stay a little longer!

Computer Lab
The computer lab is a small, square-shaped room with rows of desks facing the northern wall.  Each desk has a computer on it.

You can see Jane here.

>talk to jane
She's leaving in a big hurry.  You need to get her to stop first.

* * *

>talk to jane
You approach her cautiously and tap her on the shoulder.  As you do so, you realize that you need to go to the bathroom.  You've got to be joking!  It's too late now.  Jane is already turning around.  You'll just have to hold it.

"Hi, Jane," you mutter nervously.  "Crazy weather, huh?"
"Yeah, it sure is.  Almost magical," she replies.  "Don't you just love the rain?"

>yes
"It's amazing if you think about it," she continues, "Tons and tons of liquid water rushing down from the sky and flowing down rivers."

Her words painfully remind you that you have to pee.

"Well, anyway," you stammer, "I was just… I wanted to…"
You can't quite remember your train of thought.  This isn't good.  You're looking bad in front of Jane.  You start sweating violently.  Also not good.
"Is is hot in here, or is it just me?" you ask.
"I have some water, if you want," offers Jane.

>yes
She pulls a water bottle out of her backpack and hands it to you.  You waterfall a sizable gulp, into your mouth, much to your bladder's protest.
"So, there's the dance tonight…" you begin uneasily.
"Oh, yeah!" Jane says, "Did you know the theme is underwater?

>no
"I heard they're going to have fish tanks and water sound effects and waterfalls," she explains.

Waterfalls are not fun to think about when you have to pee.

"Do you have a date for that?" you inquire abruptly.
"Not yet," answers Jane, "If I don't get one soon, I'll probably just skip the dance and go whitewater rafting.  Have you ever been whitewater rafting?"

>no
"It's where you ride down choppy rivers in a raft," Jane elaborates, "The best part of it, I think, is just the gurgling, rushing, splashing sound the water makes."

All those sound effects make you think of is the flushing of a toilet.

"Yeah… so, do you want to come to the dance with me?" you blurt out.
"Oh.  Really?  Well…"

She's indecisive!  You should give her something to tip the scales.

>give jane flowers
"Wow, thanks!" Jane exclaims.  "That's so sweet.  You know what?  I will go to the dance with you."
She turns and walks out into the rain, and then sprints off towards the Math building.  Mission accompished: you have the perfect date to the dance.

The rain has stopped.

>wake jane
You can't see any such thing.

>undo
Computer Lab
[Previous turn undone.]

>l
Computer Lab
The computer lab is a small, square-shaped room with rows of desks facing the northern wall.  Each desk has a computer on it.

>undo
Computer Lab
[Previous turn undone.]

>l
Computer Lab
The computer lab is a small, square-shaped room with rows of desks facing the northern wall.  Each desk has a computer on it.

You can see Jane here.

>w
You bailed on Jane before she could make a decision!  She probably thinks you're a jerk now.  Nice going, you horrible person.

    *** You have lost. ***

Would you like to RESTART, RESTORE a saved game, QUIT or UNDO the last command?

>undo
Computer Lab
[Previous turn undone.]

>give jane flowers
"Wow, thanks!" Jane exclaims.  "That's so sweet.  You know what?  I will go to the dance with you."
She turns and walks out into the rain, and then sprints off towards the Math building.  Mission accompished: you have the perfect date to the dance.

>w
You can't go that way.

>w
You can't go that way.

The rain has stopped.

>l
Computer Lab
The computer lab is a small, square-shaped room with rows of desks facing the northern wall.  Each desk has a computer on it.

>e
Quad
The quad is a great grassy square with the computer lab to the west, the science building to the north, the school gym to the east, and the road to the south.  The Math, English, Social Studies, and Language buildings are behind the science building, but you don't have any of those classes today.

You can see a hooded man here.

>e
Gym

>e
Dance
You can see Jane here.

* * *

>say I win!
(to Jane)
There is no reply.

* * *

>open chest
You open the chest, revealing a spell book and a flute.

>x flute
The flute is the length of your hand, carved from wood and painted blue.  The underside is engraved with  strange symbols.  The top has several holes drilled in a line.  The shaft is hollow.  Holding it in your hand, you find that you know how to play.

>x book
It is a mystic-looking leather-bound hand-sized book.The cover is embroidered with strange symbols that you don't understand.  Somehow, the book seems to eminate pure power.

>x flute
The flute is the length of your hand, carved from wood and painted blue.  The underside is engraved with  letters and symbols similar to those on the book.  The top has several holes drilled in a line.  The shaft is hollow.

>take book
Taken.

* * *

>take flute
Taken.

>read book
It is a mystic-looking leather-bound hand-sized book.The cover is embroidered with strange symbols that you don't understand.  Somehow, the book seems to eminate pure power.

>read the book
It is a mystic-looking leather-bound hand-sized book.The cover is embroidered with strange symbols that you don't understand.  Somehow, the book seems to eminate pure power.

>read book
It is a mystic-looking leather-bound hand-sized book.The cover is embroidered with strange symbols that you don't understand.  Somehow, the book seems to eminate pure power.

* * *

>open chest
You open the chest, revealing a spell book and a flute.

>x book
It is a mystic-looking leather-bound hand-sized book.The cover is embroidered with strange symbols that you don't understand.  Somehow, the book seems to eminate pure power.

>open book
You open the book.

>take book
Taken.

* * *

>i
You're carrying nothing.  You are wearing a backpack.

>open chest
You open the chest, revealing a spell book and a flute.

* * *

>take book
Taken.

>play Decaf
You play an odd-sounding melody on the flute.
*Poof!*
A donut appears in your hand!

>i
You're carrying a spell book and a flute and 1 donut.  You are wearing a backpack.

>play Decaf
You play an odd-sounding melody on the flute.
*Poof!*
A donut appears in your hand!

>i
You're carrying a spell book and a flute and 2 donuts.  You are wearing a backpack.

* * *

>play
(the backpack)
That's not something you can play.

>open chest
You open the chest, revealing a spell book and a flute.

>play
(the backpack)
That's not something you can play.

>take flute
Taken.

>take pack
You already have that.

>wear flute
You can't wear that!

>drop flute
Dropped.

>play
(the backpack)
That's not something you can play.

>take flue
You can't see any such thing.

>take flute
Taken.

>play
What do you want to play?

>play flute
You play a charming melody on your flute.  The flute grows warm and seems to vibrate with energy--an energy almost magical.

>play
What do you want to play?

>x flute
The flute is the length of your hand, carved from wood and painted blue.  The underside is engraved with  strange symbolsThe top has several holes drilled in a line.  The shaft is hollow.  Holding it in your hand, you find that you know how to play.

* * *

>x me
You are a sixteen-year-old with dark hair and dark eyes.  You have a heavy-looking backpack on your back.

>x backpack
Your backpack is black and weighed down with all of your school books.  Your shoulders ache from wearing it.

>x chest
The chest is incredibly old-looking.  You can't make out any details under the thick layer of dust sitting on it.  It appears as though it hasn't been touched for years.

>dust chest
You achieve nothing by this.

>dust the chest
You achieve nothing by this.

* * *

>x chest
The chest is incredibly old-looking.  You can't make out any details under the thick layer of dust sitting on it.  It appears as though it hasn't been touched for years.

>open chest
You open the chest, revealing a spell book.

>x chest
The chest is incredibly old-looking.  You can't make out any details under the thick layer of dust sitting on it.  It appears as though it hasn't been touched for years.

In the chest is a spell book.

>take book
Taken.

>x book
It is a mystic-looking leather-bound hand-sized book.The cover is embroidered with strange symbols that you don't understand.  Somehow, the book seems to eminate pure power.

* * *

>open book
You open the book.

>x book
It is a mystic-looking leather-bound hand-sized book.It is open.  The pages inside are mostly covered in blank musical staffs, but the first page has a brief melody recorded.  Somehow, the book seems to eminate pure power.

>read book
It is a mystic-looking leather-bound hand-sized book.It is open.  The pages inside are mostly covered in blank musical staffs, but the first page has a brief melody recorded.  Somehow, the book seems to eminate pure power.

* * *

>take book
You can't see any such thing.

>open chest
You open the chest, revealing a spell book and a flute.

* * *

>x book
It is a mystic-looking leather-bound hand-sized book.The cover is embroidered with strange symbols that you don't understand.  Somehow, the book seems to eminate pure power.

>x book
It is a mystic-looking leather-bound hand-sized book.The cover is embroidered with strange symbols that you don't understand.  Somehow, the book seems to eminate pure power.

* * *

>x book
The book says:

To unlock things:
abcde

>take flute
Taken.

>play abcde
You play a simple scale on your flute.
You hear a click from just above you.  Looking up, you see that the basement door has somehow come unlocked.

>play abcde
You play a simple scale on your flute.

>u
(first opening the basement door)
You can't, since the basement door leads nowhere.